0010P0e0p0
10p01E1010
1X1010100K
00P0p00010
0110KC1010
000010p000