X0P000p1
e0101111
0000P011
00001000
P0E110K0
00000p1C