pEe0000ep0
011010K000
0010100010
P010X1001E
00001000eP
0e0KCP0000
0001010110
p001010001
1111010000
00000000Ee